111111
100P01
10F001
100001
111111
