1111111111111
100100P000001
1000010000001
1PPC010000001
1111111111111
