1111111
1000011
1E00001
1CP0001
1111111
