1111111111111111111111111111111111
10001000C00C000C00000C0010000000C1
10101EC100101000101001000000010101
101C111111101000001001001000010101
1P10000C0C00C000000001000000000001
1111111111111111111111111111111111
