11111111111111111
1P000000C0C00E001
11111111111111111
